*****************************************************************
*000000000000000000000000000000000000000000000000000000000000000*
*000000000000<00000000000000000000000000000000000000000000000000*
*000000000800000000000000000000000000000000000000000000000000000*
*000000000000000000000000000000000000000000000000000000000000000*
*000000000000000000000000000000000000000000000000000000000000000*
*000000000000000000000000000000000000000000000000000000000000000*
**********************000000000000000000000000000000000000000000*
*00000000000000000000*000000000000000000000000000000000000000000*
*00000000000000000000*000000000000000200000000000000000000000000*
*00000000000000000000*000000000000000000000000000000000000000000*
*00000000005000000000*000000000000000000000000000000000000000000*
*00000000000000000000*000000000000000000000000000000000000000000*
*000000000000000000000000000000000000000000000000000000000000000*
*000000000000000000000000000000000000000000000000000000000000000*
*****************************************************************